%%%%%%%%%
%       %
%   G   %
%       %
%       %
%o  P  .%
%%%%%%%%%